     ____________________________________________________________________________________________________________________________________________________________________________________________________________________________________________________________
11      |___|   |_______|___________________|___________|___|____   |   |____   |   |   |___|   |   |___________|_______|   |   |   |   |___________|___________|___|   |___|   |   |_______|________   |___|   |____   |   |_______|   |___|___________|____
10   |___________   |___|___|   |_______|   |____   |   |_______|___________|_______|_______|   |____________   |___|___|   |   |_______|___|_______________|   |________________   |____   |___________|____   |   |   |___|   |____   |_______|_______________|
9    |  |____   |___________|____   |___|___|___________________________|____   |___|___|_______________|   |   |________   |____   |   |   |___|_______|___|___________________|________   |   |___|___|   |   |____   |____   |___|   |___|___________|   |   |
8    |  |   |___|___________|   |________   |____   |___|___|   |___|_______________|   |________   |___|____   |____________   |_______|   |_______|_______|____   |_______|____   |   |____   |   |___|___|________   |___|   |____   |   |   |   |_______|___|
7    |  |___|_______________|___|____   |____   |   |_______|   |___________|___|____   |   |________   |   |___|   |   |_______|   |___|   |___|   |___|   |___|____   |_______|_______|___|____   |   |___|   |_______|   |___|   |_______|   |_______|________
6    |  |_______|   |_______|____   |___|   |   |_______|   |____   |___________|____________   |___|   |____   |___|___|   |____   |   |____   |_______|   |   |____________   |___|_______|   |___|____   |   |___|___|____   |   |___________________|____   |
5       |_______|   |___|_______|____   |___|   |____   |_______|________   |___|   |___|________   |   |____   |_______|   |   |_______________|___________|___|   |   |   |___|   |____   |   |___|   |   |____   |_______________|___|   |____________   |
4    |  |____   |___|____   |___|________________   |   |   |   |___|   |____________   |_______|_______|____________   |____________________   |___|   |___________|   |____   |___|   |___|________________   |___|________   |___|___|____   |___________|   |
3    |_______________   |___|   |   |   |   |___|   |___________|____________________   |___|___________________|___|____________   |   |_______|____   |___________|_______|   |________   |___|___________|_______________|   |___|_______|   |___________|____
2    |__|___|   |   |____   |   |   |____   |___|____   |____   |___|____   |________   |   |___|___|____   |_______|   |_______|   |___________|   |   |____   |_______|___|_______|   |___|____   |____   |_______|___|_______|___________|   |   |   |____   |
1    |  |   |____   |____   |___|_______|_______|   |   |___|   |   |________   |   |___|   |_______|___________|_______|   |_______|___________________|   |_______|   |____   |___________|___|   |___|____   |_______|____   |____   |___|   |   |___|____   |
0    |__|   |_______|___|   |____   |   |   |   |___|___________|___________|_______|___________|   |___|___________|___________|___|   |_______|   |____________   |   |___|___|____   |___|   |   |   |   |___|   |___|___|   |____   |   |________   |___|____

      0   1   2   3   4   5   6   7   8   9   10  11  12  13  14  15  16  17  18  19  20  21  22  23  24  25  26  27  28  29  30  31  32  33  34  35  36  37  38  39  40  41  42  43  44  45  46  47  48  49  50  51  52  53  54  55  56  57  58  59  60  61  62  